erezaugtanẽpo	e re zaugta nẽ po
ibaʔeraɨmãʔẽ	i baʔeraɨ mãʔẽ
manasipo	ma na sipo
oeronan	o e ro nan
orereɲ	o rere ɲ
anũpãtar	anũpã tar
poroiruwo	poro iru wo
eredʒuwedʒ	e re dʒu we dʒ
ezo	e zo
tata	ta ta
pureruraʔɨr	pureru raʔɨr
tarawadʒam	tarawadʒ am
nõdekuruo	nõ de kuru o
nõdebaʔemãʔẽkotɨ	nõ de baʔe mãʔẽ kotɨ
topaʔam	to paʔam
tazar	ta zar
wãĩwĩkom	w ãĩwĩ kom
baipuri	baipuri
kʷehe	kʷ ehe
nõdeʔaragatu	nõ de ʔara gatu
arasuka	a rasuka
pewɨkəko	pewɨkəko
zoehe	zo ehe
nõderapɨdʒ	nõ de rapɨdʒ
zadʒapɨakakom	za dʒapɨaka kom
omõgaʔu	o mõga ʔu
dereibawesipo	de reiba we sipo
pakupitaŋakom	pa ku pitaŋ a kom
eʔira	e ʔi ra
perupi	pe rupi
porozikaharate	poro zika har ate
wɨrarehe	wɨra rehe
kɨwonẽ	kɨwo nẽ
ɨwɨ	ɨwɨ
kobtar	kob tar
sĩkãĩ	sĩ kãĩ
manãto	manã to
kosokosog	kosoko so g
pɨa	pɨa
pitakom	pita kom
awurehe	awu rehe
baʔekomarehe	baʔe kom a rehe
zeburupa	zeburupa
oibao	o iba o
karaɨ	karaɨ
ʔɨ	ʔɨ
wareʔeteaʔu	war eʔe te aʔu
seg	se g
pirakomarehe	pira kom a rehe
wɨrakarakotɨ	wɨrakara kotɨ
oporahadʒ	o po rahadʒ
deruɨar	de ruɨa r
rehe	rehe
amõenam	a mõ enam
ahotar	a ho tar
dosuʔutarinam	d o suʔu tari nam
ipuriweʔe	i puri we ʔe
ewurana	e wur ana
zamãʔẽũwã	za mãʔẽ ũwã
kɨwo	kɨwo
renékotɨ	rené kotɨ
awarapɨdʒato	a wa rapɨdʒ a to
sikãĩnũwã	si kãĩ nũwã
tãõwãpo	tã õwã po
zozoga	zo zoga
okʷa	o kʷa
nõdebaʔe	nõ de baʔe
pir	pir
pureru	pureru
ekotɨ	e kotɨ
kopope	ko pope
akaʔa	a kaʔa
ko	ko
zate	za te
oapararaha	oa pararaha
oeroʔar	o e ro ʔar
pinãngala	pinãngala
damãʔẽtaraɨdʒi	d a mãʔẽtaraɨ dʒi
zawararehe	zawara rehe
ebɨgoŋ	e bɨ g oŋ
baʔehar	baʔe har
ibaʔekom	i baʔe kom
zatarawadʒ	za tarawadʒ
mamã	ma mã
sinamaripori	si namari pori
kobnẽ	kob nẽ
owɨg	o wɨg
akʷaɲ	a kʷa ɲ
ebotenam	e bo te nam
wɨrakaranũwã	wɨrakara nũwã
wɨɲakom	wɨɲa kom
ipoɨdjpɨlɨ	i poɨdj pɨlɨ
oituĩtun	o ituĩtu n
okoar	o koar
sẽswawanakom	sẽswawana kom
niwe	ni we
opukudʒ	o pukudʒ
səsəwe	sə sə we
oɨrɨru	oɨ rɨru
dekaraɨdʒi	de karaɨ dʒi
ipuruʔa	i puru ʔa
tatapewan	tata pe wan
orozopodʒ	o ro zopodʒ
ozar	o zar
oʔoʔogawĩ	o ʔoʔog awĩ
sikuwakatu	si kuwa katu
oɨrumõde	o ɨrumõ de
tukukaɨ	tuku kaɨ
kʷaraɨreherako	kʷaraɨ rehe rako
mananãhãto	ma nanãhã to
oket	o ket
erepotanẽso	erepo ta nẽ so
esisiganũwã	e sisiga nũwã
ozopodʒ	o zopodʒ
peekariɲ	pe ekar iɲ
dʒu	dʒu
ɨrukom	ɨru kom
ozopodʒo	o zopodʒ o
patupope	pa tu pope
oapar	o apa r
tazaram	ta zar am
surug	suru g
arakapusauhu	a raka pu sauhu
akaʔanũpã	a kaʔa nũpã
masakaraenam	ma sakara enam
opoʔoʔe	o poʔo ʔe
debaʔewaraso	debaʔewara so
tede	tede
taowe	ta o we
imaniaɨ	imani aɨ
pebaridʒateso	pe baridʒa te so
mokoɲtaroŋ	mokoɲ tar oŋ
urukureʔa	urukureʔa
ezeburupa	e zeburupa
mame	ma me
maiream	maire am
ozeka	o ze ka
iɲuʔaŋ	iɲuʔa ŋ
ka	ka
aŋ	a ŋ
epotaroŋ	e potar oŋ
kob	kob
owa	o wa
masogotɨ	ma so gotɨ
aiɲuŋ	a iɲuŋ
kʷər	kʷər
takuruʔar	takuru ʔar
apɨdʒakotɨ	a pɨdʒa kotɨ
deleiba	de le iba
didʒamãʔẽaɨdʒi	di dʒa mãʔẽ aɨ dʒi
nõdemõdokaroŋ	nõ de mõd okar oŋ
nõdepe	nõ de pe
otuitʃẽ	otui tʃẽ
baipurirɨepopenẽ	baipuri rɨ e pope nẽ
iwɨrakotɨʔe	i wɨra kotɨ ʔe
ozewapihipihiŋ	o ze wapihipihi ŋ
wɨraʔazozoga	wɨra ʔazo zoga
anamiaha	a namiaha
imenoŋ	i men oŋ
obowɨg	obo wɨg
owur	o wur
apɨhɨg	a pɨhɨ g
oɨruanẽʔe	o ɨru anẽ ʔe
siʔu	si ʔu
pananarebeʔɨb	pa nan arebeʔɨb
zaɨr	za ɨ r
eredʒu	e re dʒu
kɨtorehe	kɨto rehe
debaʔewarapo	debaʔewara po
penedu	pe ne du
iwɨrakotɨ	i wɨra kotɨ
dokusugi	d okusug i
mokoɲ	mokoɲ
tekeʔɨrãhã	te keʔɨ r ãhã
idʒepaila	idʒe paila
omõbakatu	o mõ ba katu
ikerape	i ker ape
ezozopodʒ	e zo zopodʒ
kʷi	kʷ i
osisigarehe	o sisiga rehe
poromõmaʔam	poro mõmaʔ am
omãʔẽõwã	o mãʔẽ õwã
orekʷarmeʔeŋoŋ	o rekʷar meʔeŋ oŋ
oiɲuŋtaroŋ	o iɲuŋ tar oŋ
ahẽ	ahẽ
okẽhemʔog	o kẽhemʔog
erezikanẽ	e re zika nẽ
akoar	a koar
nõdezar	nõ de zar
emozemohun	e moze mohun
tekoũwã	teko ũwã
urukureʔawi	urukureʔa wi
obosale	obo sale
aho	a ho
omumuɲõ	o mumu ɲõ
anami	a nami
panaĩsĩ	pa naĩsĩ
omokaʔẽpa	o mo kaʔẽ pa
nan	nan
nanãhãte	nanãhã te
toporahadʒ	to po rahadʒ
erepotar	e re po tar
tʃẽ	tʃẽ
oekar	o ekar
səwe	sə we
izonaɲapɨrɨ	i zonaɲ a pɨrɨ
cayenneawinẽ	c ayenne awi nẽ
okaʔar	okaʔar
lekolazarakom	le ko la zara kom
awata	a wata
sautu	sautu
ewinẽ	e wi nẽ
bal	bal
françoise	françoise
zoaʔɨrape	zo aʔɨrape
maŋ	ma ŋ
baʔepe	baʔepe
dekuɲaɲi	de kuɲa ɲi
dozemõdɨʔariŋ	d o zemõdɨʔari ŋ
eraho	eraho
matɨwara	matɨ wara
atɨnẽ	a tɨ nẽ
rɨru	rɨru
dawarimãʔẽenam	dawarimãʔẽ enam
obotukukokat	obo tuku ko kat
oʔao	o ʔao
waita	waita
õhem	õhem
omõbagatu	o mõ ba gatu
eremenõɲ	e re menõ ɲ
porowar	poro war
ʔɨpope	ʔɨ pope
ozoʔog	o zo ʔog
troissautskotɨ	troissauts kotɨ
apɨdʒate	a pɨdʒa te
piɲaŋi	piɲaŋ i
orɨru	o rɨru
onan	o nan
zaɨraʔɨrate	za ɨ raʔɨr ate
aʔete	aʔe te
izonaɲ	i zonaɲ
tekorehe	teko rehe
ikiʔɨ	i kiʔɨ
erepokogtar	erepo ko g tar
orohotaruwe	oro hotaru we
pemõbeʔu	pe mõ beʔu
esago	esago
kijapope	kija pope
naonan	na onan
idʒeate	idʒe ate
pitakomape	pita kom ape
apamanẽ	apam anẽ
eremozaugokar	e re mozaug okar
kʷienam	kʷ i enam
adudʒa	a du dʒa
idʒakaŋaʔar	i dʒaka ŋa ʔar
okaoka	o ka oka
oimiʔũ	o imiʔũ
disidʒapɨakadʒi	di si dʒapɨaka dʒi
emen	e men
ikɨʔa	i kɨ ʔa
ta	ta
karairupi	karai rupi
omeʔeŋgatu	o meʔeŋ gatu
obobaʔewatokat	obo baʔewato kat
onaŋ	o na ŋ
toroike	to ro ike
epe	e pe
mananeto	ma nane to
otuio	otui o
emõdur	e mõdur
ikeʔɨ	ike ʔɨ
erepotarnẽso	e re potar nẽ so
kobpakatu	kob pa katu
tou	to u
kʷienã	kʷ ienã
omõdo	o mõd o
tekoawu	te ko awu
amumuɲ	a mumu ɲ
baʔeraʔɨraʔepɨhɨgam	baʔeraʔɨra ʔe pɨhɨ g am
operoperog	o perope rog
taraɲeahẽ	taraɲe ahẽ
zoɨpɨrehe	zo ɨpɨ rehe
wɨtʃɨnũwãso	wɨtʃɨ nũwã so
eʔiʔe	e ʔi ʔe
wɨrakarakotɨnuwã	wɨrakara kotɨ nuwã
akaʔutariɲ	a kaʔu tari ɲ
ikuɲawi	i kuɲa wi
omõgaʔuokar	o mõga ʔu okar
tekorapɨdʒate	te ko rapɨdʒ ate
epaila	e paila
mokoɲamãʔẽkom	mokoɲ a mãʔẽ kom
iʔareʔe	i ʔar eʔe
siparam	sipa r am
tekokomãhã	teko kom ãhã
ijɨkom	ijɨ kom
aʔɨrate	aʔɨrate
ede	e de
kowioʔu	ko wio ʔu
wɨtʃɨnẽ	wɨtʃɨ nẽ
opokadʒaitʃe	o poka dʒa itʃe
oʔa	o ʔa
zar	zar
meʔeŋoŋ	meʔe ŋ oŋ
sa	sa
emebɨr	e mebɨr
oropõʔãeta	oro põʔã eta
bedʒu	be dʒu
ʒãdamam	ʒãdama m
apamabaʔekʷərakom	apama baʔekʷəra kom
rehete	rehe te
imodamãʔẽkom	i mod a mãʔẽ kom
aroʔa	a ro ʔa
oiɲuŋtaro	o iɲuŋ tar o
sisu	si su
takuru	ta kuru
emenatesipo	e men ate sipo
pukutʃa	pukutʃa
azikakom	a zika kom
nõdepedʒu	nõ de pe dʒu
tupa	tu pa
diawutari	di awu tari
eru	e ru
pariamoŋ	pari am oŋ
abɨr	a bɨr
tekoate	teko ate
deraɨhɨpadʒi	de raɨhɨ pa dʒi
maire	maire
azenami	a ze nami
eʔu	e ʔu
wir	wir
wɨtɨrarehe	wɨtɨ ra rehe
ozewɨro	o ze wɨr o
oesiruwanẽ	o e siruwa nẽ
kudʒaburuam	kudʒa buru am
anũpã	a nũpã
oromozonaɲokar	oro mo zonaɲ okar
derapɨdʒnane	de rapɨdʒ nane
peitʃɨitʃɨg	pe itʃɨitʃɨ g
tekeʔɨr	te keʔɨ r
ɨŋa	ɨ ŋa
aʔebarehete	aʔe ba rehe te
oiɲuŋ	o iɲuŋ
dabaʔepatari	d a baʔe pa tari
ozepɨhɨgo	o ze pɨhɨ g o
nomãʔẽtaraɨdʒimãʔẽte	n o mãʔẽtaraɨ dʒi mãʔẽ te
etaokar	e ta okar
dezarakom	de zara kom
idʒupe	i dʒupe
sujeranõãtʃã	su jeranõãtʃã
aʔenũwãso	aʔe nũwã so
pedʒapɨakaõwã	pe dʒapɨaka õwã
purerureka	pureru reka
sisigakomarehe	sisiga kom a rehe
taraɲe	taraɲe
domanõɲi	d omanõ ɲi
obodzauk	obo dzauk
arakapusawe	a raka pu sa we
poropɨhɨg	poro pɨhɨ g
tukugi	tukug i
erehe	e rehe
okẽ	o kẽ
aʔɨraterehe	aʔɨrate rehe
munuʔaŋanate	mu nuʔaŋana te
apɨka	a pɨka
ebaʔewar	e baʔe war
karaikom	karai kom
nõdebaʔekʷərawe	nõ de baʔekʷəra we
kʷaraɨpope	kʷaraɨ pope
ezozopodʒiɲ	e zo zopodʒ iɲ
ozebaradʒ	o ze baradʒ
ãhãso	ãhã so
aipo	a ipo
kupaɲ	kupa ɲ
rapɨdʒate	rapɨdʒ ate
eʔi	e ʔi
omõgaʔupa	o mõga ʔu pa
aʔɨta	a ʔɨ ta
tekokom	teko kom
wãĩwã	w ãĩwã
kudʒatãĩkɨr	kudʒa tãĩ kɨr
ãhã	ãhã
erapɨdʒtar	e rapɨdʒ tar
lekolazarate	le ko la zar ate
otuirupiwe	otui rupi we
zawarakomarehe	zawara kom a rehe
eawutar	e awu tar
ãtɨ	ãtɨ
pezika	pe zika
daepɨdʒiaʔu	d a epɨ dʒi aʔu
ʔar	ʔar
aʔebaʔekʷər	aʔe baʔekʷər
amonam	a mo nam
opoʔãpope	o poʔã pope
oeraokompa	o e ra o kom pa
tamãʔẽ	tamãʔẽ
amãʔẽnẽ	a mãʔẽ nẽ
seikokom	se iko kom
itukug	i tukug
idʒar	i dʒar
toti	to t i
oʔurtar	o ʔur tar
pekoar	pe koar
baʔepopedʒi	baʔe pope dʒi
defreãhã	de fre ãhã
epɨbɨrɨ	epɨ bɨrɨ
omõduroŋ	o mõdur oŋ
oipir	o ipir
uruwi	uru wi
ʔɨb	ʔɨb
oboʔa	o bo ʔa
sizopodʒ	si zopodʒ
orowɨgtareʔe	oro wɨg tar eʔe
zozikaa	zo zika a
ikemɨn	ikemɨn
ikɨwɨrakom	i kɨwɨra kom
diakaŋi	di akaŋ i
orohotar	oro ho tar
siʔe	si ʔe
atarawadʒiɲ	a tarawadʒ iɲ
sidʒaonẽ	si dʒao nẽ
obotekookat	obo teko o kat
apõʔãnoŋ	a põʔã n oŋ
zadʒapɨaka	za dʒapɨaka
oʔoramte	o ʔoram te
omẽbɨro	o mẽbɨr o
omõgʷeraharanẽ	o mõgʷera har anẽ
munam	mu nam
oakaŋ	o akaŋ
tab	ta b
baʔesipo	baʔe sipo
eibaŋ	e iba ŋ
lekolape	le ko la pe
otuiʔe	otui ʔe
tereraho	tere raho
kawi	ka wi
iboteaweʔe	i bo te awe ʔe
eɲuwanamenũwã	e ɲuwaname nũwã
ikijamaʔẽ	i kija maʔẽ
oiɲuŋoŋ	o iɲuŋ oŋ
pepazenam	pe paze nam
maŋato	maŋa to
kededʒu	kede dʒu
wɨɲate	wɨɲa te
aʔekɨto	aʔe kɨto
rupawəra	r upawəra
aʔe	aʔe
oerokʷa	o e ro kʷa
apoʔãetaokar	a poʔã eta okar
baʔeraʔɨrapɨhɨka	baʔeraʔɨra pɨhɨ ka
onenaŋoŋ	o nena ŋ oŋ
ʔarape	ʔar ape
deroʔoram	de ro ʔoram
ɨwɨʔar	ɨwɨ ʔar
imani	imani
sinan	si nan
terehotar	tere ho tar
datɨpɨdʒi	d a tɨpɨ dʒi
apamabaʔekʷər	apama baʔekʷər
oweroporahadʒpa	owe ropo rahadʒ pa
amanaraʔɨrate	a manar aʔɨrate
okadʒ	o ka dʒ
wɨtʃɨkuwa	wɨtʃɨ kuwa
okarabɨtebarupi	okarabɨteb a rupi
kayenape	ka yen ape
dosuʔutari	d o suʔu tari
edʒɨwe	e dʒɨ we
am	a m
sidʒu	si dʒu
kʷarapope	kʷara pope
mozepẽ	moze pẽ
ewedʒu	e wedʒu
zamãʔẽ	za mãʔẽ
pɨanam	pɨa nam
owatamaʔẽ	o wata maʔẽ
tukukimaʔẽ	tuku ki maʔẽ
zawarenam	za war enam
aʔekom	aʔe kom
napiarehe	napia rehe
orepe	o repe
zarakom	zara kom
õwem	õ we m
osuʔu	o suʔu
idʒeanẽ	idʒe anẽ
zarenũwã	za re nũwã
aʔekomãhã	a ʔe kom ãhã
edeatesipo	e de ate sipo
wanegatukuwa	wane gatu kuwa
otuiŋ	otui ŋ
pe	pe
pezezika	pe ze zika
ozikakom	o zika kom
ozaug	o zaug
siŋi	siŋ i
opa	o pa
nõdebaʔekʷərarehete	nõ de baʔekʷəra rehe te
pekariɲ	pe kari ɲ
enam	e nam
obaʔe	o baʔe
tekokomarehe	teko kom a rehe
epɨ	epɨ
tapoʔo	ta poʔo
lapotarupi	la po ta rupi
ekotɨŋ	e kotɨ ŋ
otuitaro	otui tar o
otuipamãʔẽ	otui pa mãʔẽ
zazemõapampa	za zemõapam pa
ozaramoŋ	o zar am oŋ
zapu	za pu
tukuk	tuku k
tapiʔir	tapiʔi r
arehete	a rehe te
okakuwa	o ka kuwa
idʒupekupamãʔẽ	idʒupekupa mãʔẽ
obaʔeŋ	o baʔe ŋ
tokɨr	to kɨr
aŋawi	a ŋ awi
aiɲuŋokatar	a iɲuŋ oka tar
ijɨrehewe	ijɨ rehe we
tapɨdʒam	tapɨdʒa m
eraha	e raha
piramãʔẽ	pira mãʔẽ
pazaru	pa zar u
azor	a zo r
awakʷəraraʔɨr	a wakʷəra raʔɨr
zeʔoram	ze ʔoram
okijapope	o kija pope
depeidudʒi	de pe idu dʒi
nõdezarakotɨ	nõ de zara kotɨ
omõgaguaŋ	o mõga gua ŋ
opirog	o pi rog
owɨr	o wɨr
aʔuwe	a ʔu we
eakãnũpã	e akã nũpã
inamɨɲ	i namɨɲ
amanaraʔɨraterehe	a manar aʔɨrate rehe
oweta	owe ta
kede	kede
wanemãʔẽ	wane mãʔẽ
epoʔã	e poʔã
deraɨhɨdʒi	de raɨhɨ dʒi
sikuwa	si kuwa
emõdurawĩ	e mõdur awĩ
ozezikaŋ	o ze zika ŋ
parceque	pa rceque
porowaratewe	poro war ate we
desuʔu	de suʔu
zapusĩ	za pusĩ
oʔoram	o ʔoram
aipoate	a ipo ate
tapɨdʒapope	ta pɨdʒa pope
nõderaʔɨrakomateenam	nõ de r aʔɨra kom ate enam
pedehe	pe d ehe
izazape	i za zape
wiroate	wir o ate
daʔudʒi	d a ʔu dʒi
kobtarpɨrɨ	kob tar pɨrɨ
oɨkɨdʒ	oɨ kɨ dʒ
apam	apam
omãʔẽ	o mãʔẽ
oeraho	o eraho
idʒuwiŋ	i dʒu wi ŋ
ãtɨte	ãtɨ te
idʒupekupamãʔẽpuri	idʒupekupa mãʔẽpuri
zemenõ	ze menõ
doʔudʒi	d o ʔu dʒi
səmãʔẽʔar	sə mãʔẽ ʔar
erapararaha	e ra pararaha
aku	a ku
iɲuʔaŋoŋ	iɲuʔa ŋ oŋ
ozezeka	o ze ze ka
moɲi	mo ɲi
okarabɨteb	okarabɨteb
zawaraenam	zawara enam
idʒeãhã	idʒe ãhã
iwaɲe	i waɲ e
perabkatu	pe rab katu
wɨrakaranũwãʔe	wɨrakara nũwã ʔe
ikemɨnanam	ikemɨn anam
awurtar	a wur tar
orekʷarape	o rekʷar ape
tapɨdʒabaʔehar	tapɨdʒa baʔe har
teko	teko
wãĩwĩenam	w ãĩwĩ enam
oiruo	o iru o
ɨat	ɨat
kudʒatãĩkɨrakom	kudʒa tãĩ kɨra kom
napiararehe	napia ra rehe
owata	o wata
pedapɨdʒ	pe d apɨ dʒ
dadʒaʔodʒiɲ	d a dʒaʔo dʒi ɲ
ɨɲtʃɨwi	ɨɲtʃɨ wi
emẽbɨriɲ	e mẽbɨr iɲ
imen	i men
tapɨdʒakʷər	tapɨdʒa kʷər
okusug	okusug
okero	o ker o
zaiko	za iko
maziʔogape	ma ziʔog ape
idʒe	idʒe
ozemokasinẽ	o ze mo kasi nẽ
pitaŋam	pitaŋ am
oʔuramãʔẽkom	o ʔur a mãʔẽ kom
wɨraʔa	wɨra ʔa
nanipamẽ	nani pamẽ
to	to
dorokuwadʒi	d o ro kuwa dʒi
apamaʔe	apama ʔe
takuruʔaranẽ	takuru ʔar anẽ
baʔewi	baʔe wi
aerahoraho	a eraho raho
rebe	re be
otuiomãʔẽrehe	otui o mãʔẽ rehe
aiɲuŋokartar	a iɲuŋ okar tar
irupi	i rupi
zawapinimaʔar	za wapinimaʔa r
tomãʔẽ	to mãʔẽ
naonanpɨrɨnẽ	na onan pɨrɨ nẽ
obotukuk	obo tuku k
kor	ko r
koenam	ko enam
oiɲuŋbanam	o iɲuŋ banam
okuar	o kuar
ibaʔewato	i baʔewato
zeporikatu	ze pori katu
urupẽhem	uru pẽhem
dezeburupa	de zeburupa
osapatokom	o sa pa to kom
ozebaradʒo	o ze baradʒ o
oweraho	owe raho
bodʒuhukom	bodʒuhu kom
ikotɨɲ	i kotɨ ɲ
oeta	o e ta
taʔaŋarehe	ta ʔaŋa rehe
omanõ	omanõ
paila	paila
siparate	siparate
apoʔã	a poʔã
okɨrɨg	o kɨr ɨg
ibaʔeraɨ	i baʔeraɨ
pitaŋkomape	pitaŋ kom ape
owɨb	o wɨb
pamẽitʃe	pamẽ itʃe
meneɲõkom	men e ɲõ kom
datisikədʒi	dati sikə dʒi
kotɨŋ	kotɨ ŋ
aʔeate	aʔe ate
karakuri	karakuri
raikʷara	rai kʷara
ɨaramãʔẽharakomape	ɨara mãʔẽhara kom ape
hem	hem
bapɨr	bapɨ r
dʒaiwərate	dʒaiwər ate
munuʔaŋanamte	mu nuʔaŋana m te
demebɨri	de mebɨr i
imõbo	i mõbo
owɨkɨrog	o wɨkɨ rog
tatabodʒ	tata bodʒ
dikaruginam	di karug i nam
omozezopodʒ	o moze zopodʒ
karugapopewe	karug apope we
dʒuribaweʔe	dʒur iba we ʔe
okɨr	o kɨr
okidʒewerehe	o kidʒe we rehe
pezebuʔuaiɲ	pe ze buʔua iɲ
demeni	de men i
takuruũwĩ	takuru ũwĩ
dapotari	d a potar i
nipẽam	nipẽ am
oronekomuwe	oro ne komu we
dozaugi	d o zaug i
epewaramte	e pe war am te
pirarehe	pira rehe
paku	pa ku
zeʔar	ze ʔar
iʔar	i ʔar
lekolazar	le ko la zar
zowomaʔẽkom	zo wo maʔẽ kom
otuitar	otui tar
kuʔidʒi	kuʔi dʒi
dozaʔogiŋ	d o zaʔog i ŋ
pira	pira
watekotɨwarakom	wate kotɨ wara kom
naninam	nani nam
kõʔemirehe	kõʔem i rehe
nõdeawutari	nõ de awu tari
kunumizeburupa	kunumi zeburupa
okaʔu	o kaʔu
osuʔupa	o suʔu pa
jawara	ja wara
oiba	o iba
esuʔu	e suʔu
omãʔẽmãʔẽ	o mãʔẽ mãʔẽ
ehe	ehe
nõdekom	nõ de kom
pebaridʒaso	pe baridʒa so
opɨhɨgoŋ	o pɨhɨ g oŋ
peneɨar	pe ne ɨar
zeʔari	zeʔa ri
ɨar	ɨar
dawarimãʔẽ	dawarimãʔẽ
oʔupakatu	o ʔu pa katu
zoɨpɨ	zo ɨpɨ
deru	de ru
tawadʒi	ta wa dʒi
awakʷərarehe	a wakʷəra rehe
daorɨdʒi	d a orɨ dʒi
ohoʔe	o ho ʔe
mozepẽãhã	moze pẽ ãhã
zawaro	za war o
naniãhã	nani ãhã
okoaraõwã	o ko ara õwã
dati	dati
ɨwɨkʷarapope	ɨwɨ kʷara pope
ipopewar	i pope war
ɨɲawite	ɨɲ awi te
omomokoɲanam	o mo mokoɲ anam
nameʔeŋtari	na meʔeŋ tari
baʔerehe	baʔe rehe
oʔuo	o ʔu o
atarawadʒ	a tarawadʒ
amõkomabaʔekʷəranẽ	a mõko ma baʔekʷəra nẽ
kobaitʃe	koba itʃe
nanenũwã	nane nũwã
edeãhãsa	e de ãhãsa
awapeto	a wa peto
idʒarɨdʒanam	idʒarɨdʒa nam
oboapɨg	obo apɨg
opihiokar	o pihi okar
nõdemõgʷera	nõ de mõgʷera
osiŋgar	o siŋgar
ozarareiba	o zara reiba
ozekɨesago	o ze kɨesago
pedʒu	pe dʒu
sisukija	si su kija
zeakapɨreri	ze a kapɨreri
ozemĩnõtar	o ze mĩnõ tar
sikãĩ	si kãĩ
areko	a reko
oʔaranawe	o ʔara nawe
wɨra	wɨra
so	so
baʔekʷərakom	baʔekʷəra kom
ijɨ	ijɨ
adʒumãʔẽ	adʒu mãʔẽ
oʔuwo	o ʔu wo
wãĩwĩam	w ãĩwĩ am
opɨhɨpa	o pɨhɨ pa
mama	ma ma
manãkuwapa	manã kuwa pa
omeʔeŋ	o meʔeŋ
ibaridʒa	i baridʒa
okidʒerehe	o kidʒe rehe
opopor	o popor
owag	o wag
reheʔe	rehe ʔe
ekʷa	e kʷa
tokaʔẽ	to kaʔẽ
owedʒu	o wedʒu
owawag	o wawa g
dewɨrakotɨ	de wɨra kotɨ
sede	se de
tapɨdʒarowər	tapɨdʒa rowər
sikãĩwe	si kãĩ we
nõdeawuawekuwaenam	nõ de awu awe kuwa enam
ohoɲ	o ho ɲ
kɨto	kɨto
sizika	si zika
omãʔẽo	o mãʔẽ o
zawar	za war
ɨɲ	ɨɲ
oirur	o iru r
12zaɨãhã	12zaɨãhã
kõʔem	kõʔem
ereɲ	e reɲ
okuʔeŋ	o kuʔe ŋ
roger	ro ger
mun	mu n
omõgerokar	o mõ ger okar
baripa	bari pa
mamenasinã	ma men asinã
erezor	e re zo r
arowarowagamãʔẽkom	a ro wa ro wag a mãʔẽ kom
oker	o ker
adʒutar	a dʒu tar
matɨ	matɨ
ipopenẽ	i pope nẽ
ozepir	o zepir
ozepɨhɨg	o ze pɨhɨ g
taike	ta ike
pakuʔa	pa ku ʔa
pezeboaitesipo	pezeboai te sipo
turehewe	tu rehe we
aŋeʔe	a ŋ eʔe
aʔenawe	a ʔe nawe
edeãhã	e de ãhã
enã	e nã
apamawi	apama wi
tokerako	to kerako
zabaʔeokar	za baʔe okar
channel	c han ne l
kobazepe	koba zepe
eʔinẽɨwər	e ʔinẽɨ wər
ozepotaroŋ	o ze potar oŋ
ebaridʒa	e baridʒa
dimani	d imani
okuwapɨlɨ	o kuwa pɨlɨ
urupehem	urupehem
akaŋ	akaŋ
ãhãsa	ãhãsa
omẽbɨr	o mẽbɨr
omõderehe	o mõ de rehe
tapɨdʒape	tapɨdʒa pe
oronekarakuriõwãnam	oro ne karakuri õwã nam
abaʔepotɨr	a baʔe po tɨr
camopipori	c amopi pori
derehe	de rehe
omanõmãʔẽ	omanõ mãʔẽ
kupao	kupa o
ikarug	i karug
pɨhɨka	pɨhɨ ka
ibaʔewar	i baʔe war
ekerakoɲ	e kerako ɲ
zawaram	zawara m
edɨ	e dɨ
etarawadʒ	e tarawadʒ
kupanam	kupa nam
mokoɲoŋ	mokoɲ oŋ
zozikahar	zo zika har
karaam	ka ra am
kobara	kob ara
nõdurtari	nõdu r tari
ereikɨdʒanũwã	e re ikɨdʒa nũwã
tɨãkã	tɨãkã
oboʔi	obo ʔi
oeroker	o e ro ker
orɨorɨo	o rɨorɨ o
wɨraʔauhu	wɨra ʔauhu
oʔurtaroŋ	o ʔur tar oŋ
kujã	kujã
abaʔe	a baʔe
bokalape	boka la pe
ozikapaŋ	o zika pa ŋ
kasuru	ka suru
onanmãʔẽate	onan mãʔẽ ate
toroʔu	to ro ʔu
kunumi	ku numi
tosiamnẽ	to si am nẽ
zawa	za wa
iwoʔi	i woʔi
nõdeɨane	nõ de ɨane
ozewɨkaŋ	o ze wɨka ŋ
wãĩwĩ	w ãĩwĩ
urupehemam	urupehem am
baʔekʷər	baʔekʷər
mɨdɨdʒunam	mɨ dɨdʒu nam
nõdereheo	nõ de rehe o
zaidukatukom	za idu katu kom
sibaʔetar	si baʔe tar
kir	kir
dazaugpadʒi	d a zaugpa dʒi
polo	po l o
zawararaʔɨr	zawara raʔɨr
omõwaɲ	o mõ waɲ
opaʔawo	o paʔa wo
poromokonamãʔẽate	poro mokon a mãʔẽ ate
apamabaʔepeãhã	apama baʔepe ãhã
erezika	e re zika
ebɨʔaramoŋnõwã	e bɨʔaramoŋn õwã
bodʒ	bodʒ
mɨnawe	mɨ nawe
amewar	a me war
zadʒapɨakanam	za dʒapɨaka nam
ozeʔupakaroŋ	o ze ʔupakar oŋ
amõkom	amõ kom
owir	o wir
rehedʒi	rehe dʒi
seike	se ike
dʒuriba	dʒur iba
aʔu	a ʔu
azenamiahaokar	a ze namiaha okar
izeburupanũwã	i zeburupa nũwã
akuwapakatu	a kuwa pa katu
kobãhã	kob ãhã
nebʃa	nebʃa
owataŋ	o wata ŋ
seredʒuɲ	se redʒu ɲ
zaidu	za idu
opoʔo	o poʔo
nõderɨruũwã	nõ de rɨru ũwã
noidudʒiso	n o idu dʒi so
sidʒaorehe	si dʒao rehe
baʔeraʔɨraʔepɨhɨga	baʔeraʔɨra ʔe pɨhɨ g a
matɨsipo	matɨ sipo
erepotaneso	erepo tane so
ikotɨ	i kotɨ
ɨwɨrupi	ɨwɨ rupi
tu	tu
ipope	i pope
maziʔog	ma ziʔog
ozemim	o ze mi m
ekojaram	e kojara m
ibaridʒate	i baridʒa te
ʔog	ʔog
opoanba	o poanba
zomãʔẽnanhar	zo mãʔẽnan har
derapɨdʒ	de rapɨdʒ
erenũpã	e re nũpã
otui	otui
pegotɨ	pe gotɨ
sipaʔam	si paʔam
tepedʒapɨakaõwã	te pe dʒapɨaka õwã
tapiʔirarehe	tapiʔi ra rehe
odʒapɨakamãʔẽ	o dʒapɨaka mãʔẽ
dokuwadʒi	d o kuwa dʒi
aʔenam	aʔe nam
aʔegotɨnẽʔe	aʔe gotɨ nẽ ʔe
iawu	i awu
oʔararehe	o ʔa ra rehe
apotar	a potar
sə	sə
dokte	d o k te
nãsĩʔõ	nãsĩʔõ
tuʔum	tu ʔu m
zetɨg	ze tɨ g
nõderehe	nõ de rehe
oʔar	o ʔar
teresĩ	tere sĩ
zapɨhɨpa	za pɨhɨ pa
nõde	nõ de
imõdo	i mõd o
iwɨb	i wɨb
kukupope	ku ku pope
adʒu	a dʒu
okurukagarupi	o kuru kaga rupi
aʔereiba	aʔe reiba
datikatu	dati katu
eibawe	e iba we
kaʔi	ka ʔi
itawa	i tawa
ipurite	i puri te
iawuŋ	i awu ŋ
aʔepori	aʔe pori
orekʷar	o rekʷar
wɨɲanẽ	wɨɲa nẽ
zokarakurikom	zo karakuri kom
pɨanamara	pɨa nam ara
amãʔẽ	a mãʔẽ
aiɲuŋokar	a iɲuŋ okar
odʒakaʔar	o dʒaka ʔar
zarate	zara te
kija	kija
kotɨ	kotɨ
watekotɨ	wate kotɨ
nipẽrehe	nipẽ rehe
dizeraʔenawe	di ze ra ʔe nawe
ozoka	o zoka
ikotɨŋ	i kotɨ ŋ
duʔauhu	du ʔauhu
deradʒɨr	de ra dʒɨ r
ekuʔi	e kuʔi
oʔureʔeɲ	o ʔur eʔe ɲ
pekuar	pe kuar
wane	wane
wai	wai
tazepir	ta zepir
pasiʔɨrehedʒira	pasiʔɨ rehe dʒi ra
tɨkadɨr	tɨ kadɨr
zapuru	za puru
ozikamãʔẽ	o zika mãʔẽ
ibaʔeraɨo	i baʔeraɨ o
depe	de pe
oibarehe	o iba rehe
dʒasor	dʒa so r
mais	ma is
ehekom	ehe kom
tazaugpanane	ta zaugpa nane
ononan	o n onan
nanimãʔẽra	nani mãʔẽ ra
dobaʔepakatudʒi	d o baʔe pa katu dʒi
aotar	a o tar
ozeɨruʔog	o ze ɨru ʔog
ozewa	o ze wa
sidʒapɨakaõwã	si dʒapɨaka õwã
apamaʔewi	apama ʔewi
wanekuwa	wane kuwa
zotunaʔɨɲate	zo tunaʔɨ ɲ ate
nõderapɨdʒam	nõ de rapɨdʒ am
amõ	amõ
tapug	ta pu g
oanõ	o anõ
eiba	e iba
disimãʔẽɲi	di si mãʔẽ ɲ i
idʒeenam	idʒe enam
sidʒewɨranam	si dʒ e wɨra nam
onaʔaŋtar	o naʔaŋ tar
tekoam	teko am
waɨ	waɨ
tamãʔẽpope	ta mãʔẽ pope
okaʔarokar	okaʔar okar
demõdate	de mõd ate
puri	puri
zaikonam	za iko nam
erapɨdʒape	e rapɨdʒ ape
aporoekar	a poro ekar
oapɨgeʔeo	o apɨg eʔe o
nõderapɨdʒapope	nõ de rapɨdʒ apope
ozaʔogoŋ	o zaʔog oŋ
aʔekomaraikʷararupawərareheʔe	aʔe kom ara i kʷara r upawəra rehe ʔe
baʔe	baʔe
oapɨgo	o apɨg o
nõdutari	nõdu tari
bodʒuhukomãhã	bodʒuhu kom ãhã
baʔekom	baʔe kom
ererekʷar	e re rekʷar
peotar	pe o tar
nõdeapisitanẽ	nõ de apisita nẽ
apamaʔesiparate	apama ʔe siparate
airuɲmãʔẽ	a iru ɲ mãʔẽ
dzewaka	d ze waka
sĩ	sĩ
sikədʒi	sikə dʒi
nõderaɨhɨpadʒira	nõ de raɨhɨ pa dʒi ra
edʒɨawe	e dʒɨ awe
azewirtar	a ze wir tar
eakã	e akã
ba	ba
