erezaugtanẽpo	ere zaug ta nẽ po
ibaʔeraɨmãʔẽ	i baʔe ra ɨ mãʔẽ
manasipo	ma na sipo
oeronan	o e ro nan
orereɲ	o re re ɲ
anũpãtar	a nũpã tar
poroiruwo	poro iru wo
eredʒuwedʒ	ere dʒu we dʒ
ezo	e zo
tata	ta ta
pureruraʔɨr	pureru raʔɨr
tarawadʒam	tarawa dʒ am
nõdekuruo	nõde kuru o
nõdebaʔemãʔẽkotɨ	nõde baʔe mãʔẽ kotɨ
topaʔam	t o paʔ am
tazar	ta zar
wãĩwĩkom	wãĩwĩ kom
baipuri	ba i puri
kʷehe	kʷ ehe
nõdeʔaragatu	nõde ʔar a gatu
arasuka	a ra su ka
pewɨkəko	pe wɨ kə ko
zoehe	zo ehe
nõderapɨdʒ	nõde rapɨ dʒ
zadʒapɨakakom	za d ʒapɨak a kom
omõgaʔu	o mõ ga ʔu
dereibawesipo	de reiba we sipo
pakupitaŋakom	pa ku pitaŋ a kom
eʔira	e ʔi ra
perupi	pe rupi
porozikaharate	poro zika har ate
wɨrarehe	wɨ ra rehe
kɨwonẽ	kɨ wo nẽ
ɨwɨ	ɨ wɨ
kobtar	kob tar
sĩkãĩ	s ĩ kãĩ
manãto	ma nã to
kosokosog	ko so ko so g
pɨa	pɨa
pitakom	pi ta kom
awurehe	awu rehe
baʔekomarehe	baʔe kom a rehe
zeburupa	z eburupa
oibao	o iba o
karaɨ	kara ɨ
ʔɨ	ʔɨ
wareʔeteaʔu	war eʔe te aʔu
seg	s e g
pirakomarehe	pira kom a rehe
wɨrakarakotɨ	wɨ ra kara kotɨ
oporahadʒ	o po raha dʒ
deruɨar	de ru ɨar
rehe	rehe
amõenam	a mõ enam
ahotar	a ho tar
dosuʔutarinam	d o suʔu tari nam
ipuriweʔe	i puri we ʔe
ewurana	e wur an a
zamãʔẽũwã	za mãʔẽ ũwã
kɨwo	kɨ wo
renékotɨ	re né kotɨ
awarapɨdʒato	a wa rapɨ dʒ a to
sikãĩnũwã	si kãĩ nũwã
tãõwãpo	tã õwã po
zozoga	zo zo ga
okʷa	o kʷa
nõdebaʔe	nõde baʔe
pir	pir
pureru	pureru
ekotɨ	e kotɨ
kopope	ko pope
akaʔa	a ka ʔa
ko	ko
zate	z ate
oapararaha	o a pa ra raha
oeroʔar	o e ro ʔar
pinãngala	pi nã ngala
damãʔẽtaraɨdʒi	d a mãʔẽ tar a ɨ dʒi
zawararehe	za wa ra rehe
ebɨgoŋ	e bɨ g oŋ
baʔehar	baʔe har
ibaʔekom	iba ʔe kom
zatarawadʒ	za tarawa dʒ
mamã	ma mã
sinamaripori	si nam a ri po ri
kobnẽ	kob nẽ
owɨg	o wɨ g
akʷaɲ	a kʷa ɲ
ebotenam	e bo t enam
wɨrakaranũwã	wɨ ra kara nũwã
wɨɲakom	wɨ ɲ a kom
ipoɨdjpɨlɨ	i po ɨ dj pɨlɨ
oituĩtun	o i tuĩtun
okoar	o koar
sẽswawanakom	s ẽs wa wa n a kom
niwe	ni we
opukudʒ	o puku dʒ
səsəwe	sə sə we
oɨrɨru	o ɨ rɨru
dekaraɨdʒi	de kara ɨ dʒi
ipuruʔa	ip uru ʔa
tatapewan	ta ta pe wa n
orozopodʒ	o ro zopodʒ
ozar	o zar
oʔoʔogawĩ	o ʔo ʔog awĩ
sikuwakatu	si ku wa katu
oɨrumõde	o ɨ ru mõd e
tukukaɨ	tu ku k aɨ
kʷaraɨreherako	kʷ a ra ɨ rehe ra ko
mananãhãto	ma nan ãhã to
oket	o ket
erepotanẽso	ere po ta nẽ so
esisiganũwã	e si siga nũwã
ozopodʒ	o zopodʒ
peekariɲ	pe ekar iɲ
dʒu	dʒu
ɨrukom	ɨru kom
ozopodʒo	o zopodʒ o
patupope	pa tu pope
oapar	oa par
tazaram	ta zar am
surug	suru g
arakapusauhu	arak apusa uhu
akaʔanũpã	a ka ʔa nũpã
masakaraenam	ma s a kara enam
opoʔoʔe	o poʔo ʔe
debaʔewaraso	de baʔe wara so
tede	t ede
taowe	ta o we
imaniaɨ	imani aɨ
pebaridʒateso	pe bari dʒa te so
mokoɲtaroŋ	mokoɲ tar oŋ
urukureʔa	uru ku re ʔa
ezeburupa	e z eburupa
mame	ma me
maiream	ma i re am
ozeka	o ze ka
iɲuʔaŋ	i ɲ uʔaŋ
ka	ka
aŋ	a ŋ
epotaroŋ	e po tar oŋ
kob	kob
owa	o wa
masogotɨ	ma s o gotɨ
aiɲuŋ	a iɲuŋ
kʷər	kʷər
takuruʔar	ta ku ru ʔar
apɨdʒakotɨ	a pɨ dʒa kotɨ
deleiba	de le iba
didʒamãʔẽaɨdʒi	d i dʒa mãʔẽ aɨ dʒi
nõdemõdokaroŋ	nõde mõd okar oŋ
nõdepe	nõde pe
otuitʃẽ	o tu i tʃẽ
baipurirɨepopenẽ	ba i puri rɨe pope nẽ
iwɨrakotɨʔe	i wɨ ra kotɨ ʔe
ozewapihipihiŋ	o ze wa pi h i pihi ŋ
wɨraʔazozoga	wɨ raʔ a zo zo g a
anamiaha	a namiaha
imenoŋ	i men oŋ
obowɨg	obo wɨ g
owur	o wur
apɨhɨg	a pɨhɨ g
oɨruanẽʔe	o ɨ ru a nẽ ʔe
siʔu	si ʔu
pananarebeʔɨb	pa na na re beʔɨ b
zaɨr	za ɨr
eredʒu	ere dʒu
kɨtorehe	kɨ to rehe
debaʔewarapo	de baʔe wara po
penedu	pe ne du
iwɨrakotɨ	i wɨ ra kotɨ
dokusugi	d okusug i
mokoɲ	mokoɲ
tekeʔɨrãhã	te keʔ ɨr ãhã
idʒepaila	i dʒ ep aila
omõbakatu	o mõ ba katu
ikerape	i ker ape
ezozopodʒ	e zo zopodʒ
kʷi	kʷi
osisigarehe	o si siga rehe
poromõmaʔam	poro mõ ma ʔ am
omãʔẽõwã	o mãʔẽ õwã
orekʷarmeʔeŋoŋ	o re kʷ ar meʔe ŋ oŋ
oiɲuŋtaroŋ	o iɲuŋ tar oŋ
ahẽ	a hẽ
okẽhemʔog	okẽ hem ʔog
erezikanẽ	ere zika nẽ
akoar	a koar
nõdezar	nõde zar
emozemohun	e mo ze mo h un
tekoũwã	teko ũwã
urukureʔawi	uru ku re ʔa wi
obosale	obo sale
aho	a ho
omumuɲõ	o mumu ɲõ
anami	a nam i
panaĩsĩ	pa na ĩ sĩ
omokaʔẽpa	o mo kaʔẽ pa
nan	nan
nanãhãte	nan ãhã te
toporahadʒ	t o po raha dʒ
erepotar	ere po ta r
tʃẽ	tʃẽ
oekar	o ekar
səwe	sə we
izonaɲapɨrɨ	i zo na ɲa pɨrɨ
cayenneawinẽ	c ayen nea wi nẽ
okaʔar	o ka ʔar
lekolazarakom	le ko la zar a kom
awata	a wa ta
sautu	sau tu
ewinẽ	e wi nẽ
bal	ba l
françoise	fran çoise
zoaʔɨrape	zo aʔɨr ape
maŋ	m a ŋ
baʔepe	baʔe pe
dekuɲaɲi	de ku ɲa ɲi
dozemõdɨʔariŋ	d o ze mõd ɨ ʔar i ŋ
eraho	eraho
matɨwara	ma tɨ wara
atɨnẽ	a tɨ nẽ
rɨru	rɨru
dawarimãʔẽenam	da wa ri mãʔẽ enam
obotukukokat	obo tu ku k okat
oʔao	o ʔa o
waita	wa i ta
õhem	õ hem
omõbagatu	o mõ ba gatu
eremenõɲ	ere men õ ɲ
porowar	poro war
ʔɨpope	ʔɨ pope
ozoʔog	o zo ʔog
troissautskotɨ	t ro i s sau t s kotɨ
apɨdʒate	a pɨ dʒ ate
piɲaŋi	pi ɲa ŋ i
orɨru	o rɨru
onan	o nan
zaɨraʔɨrate	za ɨ raʔɨr ate
aʔete	a ʔe te
izonaɲ	i zo na ɲ
tekorehe	te ko rehe
ikiʔɨ	i k i ʔɨ
erepokogtar	ere po ko g tar
orohotaruwe	oro ho tar u we
pemõbeʔu	pe mõ be ʔu
esago	e sago
kijapope	kij a pope
naonan	na o nan
idʒeate	i dʒ e ate
pitakomape	pi ta kom ape
apamanẽ	apam a nẽ
eremozaugokar	ere mo zaug okar
kʷienam	kʷi enam
adudʒa	a du dʒa
idʒakaŋaʔar	i dʒ akaŋ a ʔar
okaoka	o ka o ka
oimiʔũ	o imiʔũ
disidʒapɨakadʒi	d i si d ʒapɨak a dʒi
emen	e men
ikɨʔa	i k ɨ ʔa
ta	ta
karairupi	kar a i rupi
omeʔeŋgatu	o meʔe ŋ gatu
obobaʔewatokat	obo baʔe wat okat
onaŋ	o na ŋ
toroike	t oro ike
epe	e pe
mananeto	ma nan e to
otuio	o tu i o
emõdur	e mõd ur
ikeʔɨ	ike ʔɨ
erepotarnẽso	ere po tar nẽ so
kobpakatu	kob pa katu
tou	t o u
kʷienã	kʷ i e nã
omõdo	o mõd o
tekoawu	te ko awu
amumuɲ	a mumu ɲ
baʔeraʔɨraʔepɨhɨgam	baʔe raʔ ɨ ra ʔ epɨhɨ g am
operoperog	o pe ro pe ro g
taraɲeahẽ	ta ra ɲe a hẽ
zoɨpɨrehe	zo ɨpɨ rehe
wɨtʃɨnũwãso	wɨ tʃɨ nũwã so
eʔiʔe	e ʔi ʔe
wɨrakarakotɨnuwã	wɨ ra kara kotɨ nuwã
akaʔutariɲ	a k a ʔu tar iɲ
ikuɲawi	i ku ɲa wi
omõgaʔuokar	o mõ ga ʔu okar
tekorapɨdʒate	te ko rapɨ dʒ ate
epaila	ep aila
mokoɲamãʔẽkom	mokoɲ a mãʔẽ kom
iʔareʔe	i ʔar eʔe
siparam	si pa r am
tekokomãhã	teko kom ãhã
ijɨkom	ijɨ kom
aʔɨrate	aʔɨr ate
ede	ede
kowioʔu	ko wi o ʔu
wɨtʃɨnẽ	wɨ tʃɨ nẽ
opokadʒaitʃe	o po ka dʒa itʃe
oʔa	o ʔa
zar	zar
meʔeŋoŋ	meʔe ŋ oŋ
sa	s a
emebɨr	e me bɨr
oropõʔãeta	oro põʔã e ta
bedʒu	be dʒ u
ʒãdamam	ʒãd am am
apamabaʔekʷərakom	apam a baʔe kʷər a kom
rehete	rehe te
imodamãʔẽkom	i mo d a mãʔẽ kom
aroʔa	a ro ʔa
oiɲuŋtaro	o iɲuŋ tar o
sisu	si su
takuru	ta kuru
emenatesipo	e men ate sipo
pukutʃa	puku t ʃa
azikakom	a zika kom
nõdepedʒu	nõde pe dʒ u
tupa	tu pa
diawutari	d i awu tari
eru	e ru
pariamoŋ	par i am oŋ
abɨr	a bɨr
tekoate	teko ate
deraɨhɨpadʒi	de ra ɨhɨ pa dʒi
maire	ma i re
azenami	a z enam i
eʔu	e ʔu
wir	wir
wɨtɨrarehe	wɨ tɨ ra rehe
ozewɨro	o ze wɨr o
oesiruwanẽ	o e si ru wa nẽ
kudʒaburuam	ku dʒ a bu ru am
anũpã	a nũpã
oromozonaɲokar	oro mo zo na ɲ okar
derapɨdʒnane	de rapɨ dʒ nane
peitʃɨitʃɨg	pe i tʃɨ itʃɨg
tekeʔɨr	te keʔ ɨr
ɨŋa	ɨ ŋa
aʔebarehete	aʔe ba rehe te
oiɲuŋ	o iɲuŋ
dabaʔepatari	da baʔe pa tari
ozepɨhɨgo	o ze pɨhɨ g o
nomãʔẽtaraɨdʒimãʔẽte	no mãʔẽ tar aɨ dʒi mãʔẽ te
etaokar	e ta okar
dezarakom	de zar a kom
idʒupe	idʒu pe
sujeranõãtʃã	su jeran õãtʃã
aʔenũwãso	a ʔe nũwã so
pedʒapɨakaõwã	pe d ʒapɨak a õwã
purerureka	pureru reka
sisigakomarehe	si siga kom a rehe
taraɲe	ta ra ɲ e
domanõɲi	d omanõ ɲi
obodzauk	obo d za uk
arakapusawe	arak apusa we
poropɨhɨg	poro pɨhɨ g
tukugi	tu ku gi
erehe	e rehe
okẽ	okẽ
aʔɨraterehe	aʔɨr ate rehe
munuʔaŋanate	mun uʔaŋ an ate
apɨka	a pɨ ka
ebaʔewar	e baʔe war
karaikom	kara i kom
nõdebaʔekʷərawe	nõde baʔe kʷər a we
kʷaraɨpope	kʷ a ra ɨ po pe
ezozopodʒiɲ	e zo zopodʒ iɲ
ozebaradʒ	o ze bara dʒ
ãhãso	ãhã so
aipo	a i po
kupaɲ	ku pa ɲ
rapɨdʒate	ra pɨ dʒ ate
eʔi	e ʔi
omõgaʔupa	o mõ ga ʔu pa
aʔɨta	a ʔɨ ta
tekokom	teko kom
wãĩwã	wãĩwã
kudʒatãĩkɨr	ku dʒ atãĩk ɨr
ãhã	ãhã
erapɨdʒtar	e rapɨ dʒ tar
lekolazarate	le ko la zar ate
otuirupiwe	o tu i rupi we
zawarakomarehe	za wa r a kom a rehe
eawutar	e awu tar
ãtɨ	ã tɨ
pezika	pe zika
daepɨdʒiaʔu	da e pɨ dʒi aʔu
ʔar	ʔar
aʔebaʔekʷər	aʔe baʔe kʷər
amonam	a mo nam
opoʔãpope	o poʔã pope
oeraokompa	o e ra o kom pa
tamãʔẽ	ta mãʔẽ
amãʔẽnẽ	a mãʔẽ nẽ
seikokom	s e iko kom
itukug	i tu ku g
idʒar	i dʒ a r
toti	t o t i
oʔurtar	o ʔur tar
pekoar	pe koar
baʔepopedʒi	baʔe pope dʒi
defreãhã	de fre ãhã
epɨbɨrɨ	e pɨ bɨr ɨ
omõduroŋ	o mõd ur oŋ
oipir	o i pir
uruwi	uru wi
ʔɨb	ʔɨ b
oboʔa	obo ʔa
sizopodʒ	si zopodʒ
orowɨgtareʔe	oro wɨ g tar eʔe
zozikaa	zo zika a
ikemɨn	ike mɨ n
ikɨwɨrakom	i k ɨ wɨr a kom
diakaŋi	d i akaŋ i
orohotar	oro ho tar
siʔe	si ʔe
atarawadʒiɲ	a tarawa dʒi ɲ
sidʒaonẽ	si dʒ a o nẽ
obotekookat	obo teko okat
apõʔãnoŋ	a põʔã no ŋ
zadʒapɨaka	za d ʒapɨak a
oʔoramte	o ʔor am te
omẽbɨro	o mẽ bɨr o
omõgʷeraharanẽ	o mõ gʷera har a nẽ
munam	mun am
oakaŋ	o akaŋ
tab	ta b
baʔesipo	baʔe sipo
eibaŋ	e iba ŋ
lekolape	le ko la pe
otuiʔe	o tu i ʔe
tereraho	te re raho
kawi	ka wi
iboteaweʔe	i bo te a we ʔe
eɲuwanamenũwã	eɲu wa nam e nũwã
ikijamaʔẽ	i kij a maʔẽ
oiɲuŋoŋ	o iɲuŋ oŋ
pepazenam	pe pa ze nam
maŋato	ma ŋa to
kededʒu	k ede dʒ u
wɨɲate	wɨ ɲa te
aʔekɨto	aʔe kɨ to
rupawəra	r upawəra
aʔe	a ʔe
oerokʷa	o e ro kʷa
apoʔãetaokar	a poʔã e ta okar
baʔeraʔɨrapɨhɨka	baʔe raʔ ɨ ra pɨhɨ ka
onenaŋoŋ	o ne na ŋ oŋ
ʔarape	ʔar ape
deroʔoram	de ro ʔor am
ɨwɨʔar	ɨ wɨ ʔar
imani	imani
sinan	si nan
terehotar	te re ho tar
datɨpɨdʒi	da t ɨpɨ dʒi
apamabaʔekʷər	apam a baʔe kʷər
oweroporahadʒpa	o we r o po raha dʒ pa
amanaraʔɨrate	a ma na raʔ ɨr ate
okadʒ	o ka dʒ
wɨtʃɨkuwa	wɨ tʃɨ kuwa
okarabɨtebarupi	o kar abɨteb arupi
kayenape	k ayen a pe
dosuʔutari	d o suʔu tari
edʒɨwe	e dʒ ɨ we
am	a m
sidʒu	si dʒu
kʷarapope	kʷa ra pope
mozepẽ	mo ze pẽ
ewedʒu	e we dʒ u
zamãʔẽ	za mãʔẽ
pɨanam	pɨ a nam
owatamaʔẽ	o wa t a maʔẽ
tukukimaʔẽ	tu ku ki maʔẽ
zawarenam	za war enam
aʔekom	a ʔe kom
napiarehe	na pi a rehe
orepe	o re pe
zarakom	zar a kom
õwem	õ we m
osuʔu	o suʔu
idʒeanẽ	i dʒ e a nẽ
zarenũwã	zar e nũwã
aʔekomãhã	aʔe ko m ãhã
edeatesipo	ede ate sipo
wanegatukuwa	wa n e gatu kuwa
otuiŋ	o tu i ŋ
pe	pe
pezezika	pe ze zika
ozikakom	o zika kom
ozaug	o zaug
siŋi	si ŋ i
opa	o pa
nõdebaʔekʷərarehete	nõde baʔe kʷər a rehe te
pekariɲ	pe ka ri ɲ
enam	e nam
obaʔe	o baʔe
tekokomarehe	teko kom a rehe
epɨ	e pɨ
tapoʔo	ta poʔo
lapotarupi	la po t arupi
ekotɨŋ	e kotɨ ŋ
otuitaro	o tu i tar o
otuipamãʔẽ	o tu i pa mãʔẽ
zazemõapampa	za ze mõ apam pa
ozaramoŋ	o zar am oŋ
zapu	za pu
tukuk	tu ku k
tapiʔir	ta pi ʔi r
arehete	a rehe te
okakuwa	o ka kuwa
idʒupekupamãʔẽ	idʒu pe ku pa mãʔẽ
obaʔeŋ	o baʔe ŋ
tokɨr	t o kɨr
aŋawi	a ŋa wi
aiɲuŋokatar	a iɲuŋ o ka tar
ijɨrehewe	ijɨ rehe we
tapɨdʒam	t apɨ dʒ a m
eraha	e raha
piramãʔẽ	pira mãʔẽ
pazaru	pa zar u
azor	a zo r
awakʷəraraʔɨr	a wa kʷər a raʔɨr
zeʔoram	ze ʔor am
okijapope	o kij a pope
depeidudʒi	de pe idu dʒi
nõdezarakotɨ	nõde zar a kotɨ
omõgaguaŋ	o mõ ga gua ŋ
opirog	o pir og
owɨr	o wɨr
aʔuwe	a ʔu we
eakãnũpã	eakã nũpã
inamɨɲ	i na mɨ ɲ
amanaraʔɨraterehe	a ma na raʔ ɨr ate rehe
oweta	o we ta
kede	k ede
wanemãʔẽ	wa n e mãʔẽ
epoʔã	e poʔã
deraɨhɨdʒi	de ra ɨhɨ dʒi
sikuwa	si kuwa
emõdurawĩ	e mõd ur awĩ
ozezikaŋ	o ze zika ŋ
parceque	par cequ e
porowaratewe	poro war ate we
desuʔu	de suʔu
zapusĩ	zap u sĩ
oʔoram	o ʔor am
aipoate	a i po ate
tapɨdʒapope	t apɨ dʒ a po pe
nõderaʔɨrakomateenam	nõde ra ʔɨ ra kom ate enam
pedehe	pe d ehe
izazape	i za za pe
wiroate	wir o ate
daʔudʒi	da ʔu dʒi
kobtarpɨrɨ	kob tar pɨrɨ
oɨkɨdʒ	o ɨ kɨ dʒ
apam	a p am
omãʔẽ	o mãʔẽ
oeraho	o eraho
idʒuwiŋ	idʒu wi ŋ
ãtɨte	ã tɨ te
idʒupekupamãʔẽpuri	idʒu pe ku pa mãʔẽ pu ri
zemenõ	ze men õ
doʔudʒi	d o ʔu dʒi
səmãʔẽʔar	sə mãʔẽ ʔar
erapararaha	e ra pa ra raha
aku	a ku
iɲuʔaŋoŋ	i ɲ uʔaŋ oŋ
ozezeka	o ze ze ka
moɲi	mo ɲ i
okarabɨteb	o kar abɨteb
zawaraenam	za wa r a enam
idʒeãhã	i dʒ e ãhã
iwaɲe	i wa ɲ e
perabkatu	pe ra b katu
wɨrakaranũwãʔe	wɨ ra kara nũwã ʔe
ikemɨnanam	ike mɨ nan am
awurtar	awu r tar
orekʷarape	o re kʷ ar a pe
tapɨdʒabaʔehar	t apɨ dʒ a baʔe har
teko	teko
wãĩwĩenam	wãĩwĩ enam
oiruo	o i ru o
ɨat	ɨ a t
kudʒatãĩkɨrakom	ku dʒ atãĩk ɨr a kom
napiararehe	na pi a ra rehe
owata	o wa ta
pedapɨdʒ	pe da pɨ dʒ
dadʒaʔodʒiɲ	da dʒ a ʔo dʒi ɲ
ɨɲtʃɨwi	ɨɲ tʃɨ wi
emẽbɨriɲ	e mẽ bɨr iɲ
imen	i men
tapɨdʒakʷər	t apɨ dʒ a kʷər
okusug	okusug
okero	o ker o
zaiko	za iko
maziʔogape	ma zi ʔog ape
idʒe	i dʒ e
ozemokasinẽ	o ze mo kasi nẽ
pitaŋam	pitaŋ am
oʔuramãʔẽkom	o ʔur a mãʔẽ kom
wɨraʔa	wɨ ra ʔa
nanipamẽ	na ni pamẽ
to	t o
dorokuwadʒi	d o ro kuwa dʒi
apamaʔe	apam a ʔe
takuruʔaranẽ	ta ku ru ʔar a nẽ
baʔewi	baʔe wi
aerahoraho	a eraho raho
rebe	re be
otuiomãʔẽrehe	o tu i o mãʔẽ rehe
aiɲuŋokartar	a iɲuŋ okar tar
irupi	i rupi
zawapinimaʔar	za wa pi ni ma ʔar
tomãʔẽ	t o mãʔẽ
naonanpɨrɨnẽ	na o nan pɨrɨ nẽ
obotukuk	obo tu ku k
kor	ko r
koenam	k o enam
oiɲuŋbanam	o iɲuŋ b a nam
okuar	o kuar
ibaʔewato	i baʔe wa to
zeporikatu	ze po ri katu
urupẽhem	uru pẽ hem
dezeburupa	de z eburupa
osapatokom	o s a pa to kom
ozebaradʒo	o ze bara dʒ o
oweraho	o we raho
bodʒuhukom	bo dʒ uhu kom
ikotɨɲ	i kotɨ ɲ
oeta	o e ta
taʔaŋarehe	ta ʔa ŋ a rehe
omanõ	omanõ
paila	p aila
siparate	si par ate
apoʔã	a poʔã
okɨrɨg	o kɨr ɨ g
ibaʔeraɨ	i baʔe ra ɨ
pitaŋkomape	pitaŋ kom ape
owɨb	o wɨ b
pamẽitʃe	pamẽ itʃe
meneɲõkom	men e ɲõ kom
datisikədʒi	da t i si kə dʒi
kotɨŋ	kotɨ ŋ
aʔeate	aʔe a te
karakuri	karaku ri
raikʷara	ra i kʷa ra
ɨaramãʔẽharakomape	ɨar a mãʔẽ har a kom ape
hem	hem
bapɨr	ba pɨ r
dʒaiwərate	dʒ a i wər ate
munuʔaŋanamte	mun uʔaŋ a nam te
demebɨri	de me bɨr i
imõbo	i mõ bo
owɨkɨrog	o wɨ kɨr og
tatabodʒ	ta ta bo dʒ
dikaruginam	d ikarug i nam
omozezopodʒ	o mo ze zopodʒ
karugapopewe	kar u g a pope we
dʒuribaweʔe	dʒ ur iba we ʔe
okɨr	o kɨr
okidʒewerehe	o k i dʒ e we rehe
pezebuʔuaiɲ	pe ze buʔua iɲ
demeni	de men i
takuruũwĩ	ta ku ru ũwĩ
dapotari	da po tari
nipẽam	ni pẽ am
oronekomuwe	oro ne ko mu we
dozaugi	d o zaug i
epewaramte	e pe war am te
pirarehe	pira rehe
paku	pa ku
zeʔar	ze ʔar
iʔar	i ʔar
lekolazar	le ko la zar
zowomaʔẽkom	zo wo maʔẽ kom
otuitar	o tu i tar
kuʔidʒi	ku ʔi dʒi
dozaʔogiŋ	d o z a ʔog i ŋ
pira	pira
watekotɨwarakom	wa t e kotɨ wara kom
naninam	na ni nam
kõʔemirehe	kõʔem i rehe
nõdeawutari	nõde awu tari
kunumizeburupa	kunum i z eburupa
okaʔu	o ka ʔu
osuʔupa	o suʔu pa
jawara	ja wara
oiba	o iba
esuʔu	e suʔu
omãʔẽmãʔẽ	o mãʔẽ mãʔẽ
ehe	ehe
nõdekom	nõde ko m
pebaridʒaso	pe bari dʒa so
opɨhɨgoŋ	o pɨhɨ g oŋ
peneɨar	pe ne ɨar
zeʔari	ze ʔar i
ɨar	ɨar
dawarimãʔẽ	da war i mãʔẽ
oʔupakatu	o ʔu pa katu
zoɨpɨ	zo ɨpɨ
deru	de ru
tawadʒi	ta wa dʒi
awakʷərarehe	a wa kʷər a rehe
daorɨdʒi	da orɨ dʒi
ohoʔe	o ho ʔe
mozepẽãhã	mo ze pẽ ãhã
zawaro	za wa r o
naniãhã	na ni ãhã
okoaraõwã	o koar a õwã
dati	da t i
ɨwɨkʷarapope	ɨ wɨ kʷa ra pope
ipopewar	i pope war
ɨɲawite	ɨɲ a wi te
omomokoɲanam	o mo mokoɲ a nam
nameʔeŋtari	na meʔe ŋ tari
baʔerehe	baʔe rehe
oʔuo	o ʔu o
atarawadʒ	a tarawa dʒ
amõkomabaʔekʷəranẽ	a mõ ko ma baʔe kʷər a nẽ
kobaitʃe	ko ba itʃe
nanenũwã	nan e nũwã
edeãhãsa	ede ãhã sa
awapeto	a wa pe to
idʒarɨdʒanam	i dʒ ar ɨ dʒa nam
oboapɨg	obo apɨg
opihiokar	o pihi okar
nõdemõgʷera	nõde mõ gʷera
osiŋgar	o si ŋ ga r
ozarareiba	o za ra reiba
ozekɨesago	o ze kɨ e sago
pedʒu	pe dʒu
sisukija	si su kij a
zeakapɨreri	ze ak apɨ re ri
ozemĩnõtar	o ze mĩn õ tar
sikãĩ	si kãĩ
areko	a re ko
oʔaranawe	o ʔar an a we
wɨra	wɨ ra
so	s o
baʔekʷərakom	baʔe kʷər a kom
ijɨ	ijɨ
adʒumãʔẽ	a dʒu mãʔẽ
oʔuwo	o ʔu wo
wãĩwĩam	wãĩwĩ am
opɨhɨpa	o pɨhɨ pa
mama	ma m a
manãkuwapa	ma nã kuwa pa
omeʔeŋ	o meʔe ŋ
ibaridʒa	i bari dʒa
okidʒerehe	o k i dʒ e rehe
opopor	o po po r
owag	o wag
reheʔe	rehe ʔe
ekʷa	e kʷa
tokaʔẽ	t o kaʔẽ
owedʒu	o we dʒ u
owawag	o wa wa g
dewɨrakotɨ	de wɨr a kotɨ
sede	s ede
tapɨdʒarowər	t apɨ dʒ a ro wər
sikãĩwe	si kãĩ we
nõdeawuawekuwaenam	nõde awu a we kuwa enam
ohoɲ	o ho ɲ
kɨto	kɨ to
sizika	si zika
omãʔẽo	o mãʔẽ o
zawar	za war
ɨɲ	ɨ ɲ
oirur	o iru r
12zaɨãhã	12 za ɨ ãhã
kõʔem	kõʔem
ereɲ	ere ɲ
okuʔeŋ	o ku ʔe ŋ
roger	ro ger
mun	mun
omõgerokar	o mõ ger okar
baripa	bari pa
mamenasinã	ma men asinã
erezor	ere zo r
arowarowagamãʔẽkom	a ro wa ro wag a mãʔẽ kom
oker	o ker
adʒutar	a dʒu tar
matɨ	ma tɨ
ipopenẽ	i pope nẽ
ozepir	o ze pir
ozepɨhɨg	o ze pɨhɨ g
taike	ta ike
pakuʔa	pa ku ʔa
pezeboaitesipo	pe ze bo a i te sipo
turehewe	tu rehe we
aŋeʔe	a ŋ eʔe
aʔenawe	aʔe na we
edeãhã	ede ãhã
enã	e nã
apamawi	apam a wi
tokerako	t o kera ko
zabaʔeokar	za baʔe okar
channel	c hanne l
kobazepe	ko ba ze pe
eʔinẽɨwər	e ʔi nẽ ɨ wər
ozepotaroŋ	o ze po tar oŋ
ebaridʒa	e bari dʒa
dimani	d imani
okuwapɨlɨ	o kuwa pɨlɨ
urupehem	uru pe hem
akaŋ	akaŋ
ãhãsa	ãhã sa
omẽbɨr	o mẽ bɨr
omõderehe	o mõd e rehe
tapɨdʒape	t apɨ dʒ a pe
oronekarakuriõwãnam	oro ne karaku ri õwã nam
abaʔepotɨr	a baʔe po tɨr
camopipori	c a mo pi po ri
derehe	de rehe
omanõmãʔẽ	omanõ mãʔẽ
kupao	ku pa o
ikarug	ikarug
pɨhɨka	pɨhɨ ka
ibaʔewar	i baʔe war
ekerakoɲ	e kera ko ɲ
zawaram	za war am
edɨ	ed ɨ
etarawadʒ	e tarawa dʒ
kupanam	ku pa nam
mokoɲoŋ	mokoɲ oŋ
zozikahar	zo zika har
karaam	kara am
kobara	ko bara
nõdurtari	nõd ur ta ri
ereikɨdʒanũwã	ere i kɨ dʒa nũwã
tɨãkã	t ɨãkã
oboʔi	obo ʔi
oeroker	o e ro ker
orɨorɨo	o rɨorɨ o
wɨraʔauhu	wɨ ra ʔa uhu
oʔurtaroŋ	o ʔur tar oŋ
kujã	ku jã
abaʔe	a baʔe
bokalape	bo ka l ape
ozikapaŋ	o zika pa ŋ
kasuru	ka suru
onanmãʔẽate	o nan mãʔẽ ate
toroʔu	t oro ʔu
kunumi	kunum i
tosiamnẽ	t o si am nẽ
zawa	za wa
iwoʔi	i wo ʔi
nõdeɨane	nõde ɨan e
ozewɨkaŋ	o ze wɨ ka ŋ
wãĩwĩ	wãĩwĩ
urupehemam	uru pe hem am
baʔekʷər	baʔe kʷər
mɨdɨdʒunam	mɨ d ɨ dʒu nam
nõdereheo	nõde rehe o
zaidukatukom	za idu katu kom
sibaʔetar	si baʔe tar
kir	ki r
dazaugpadʒi	da zaug pa dʒi
polo	po l o
zawararaʔɨr	za war a raʔɨr
omõwaɲ	o mõ wa ɲ
opaʔawo	o paʔ a wo
poromokonamãʔẽate	poro mo ko na mãʔẽ ate
apamabaʔepeãhã	apam a baʔe pe ãhã
erezika	ere zika
ebɨʔaramoŋnõwã	e bɨ ʔar am oŋ n õwã
bodʒ	bo dʒ
mɨnawe	mɨ na we
amewar	a me war
zadʒapɨakanam	za d ʒapɨak a nam
ozeʔupakaroŋ	o ze ʔu pa ka r oŋ
amõkom	a mõ kom
owir	o wir
rehedʒi	rehe dʒi
seike	s e ike
dʒuriba	dʒ ur iba
aʔu	a ʔu
azenamiahaokar	a ze namiaha okar
izeburupanũwã	i z eburupa nũwã
akuwapakatu	a kuwa pa katu
kobãhã	kob ãhã
nebʃa	ne b ʃa
owataŋ	o wa ta ŋ
seredʒuɲ	s ere dʒu ɲ
zaidu	za idu
opoʔo	o poʔo
nõderɨruũwã	nõde rɨru ũwã
noidudʒiso	n o idu dʒi so
sidʒaorehe	si dʒ a o rehe
baʔeraʔɨraʔepɨhɨga	baʔe raʔ ɨ ra ʔ epɨhɨ ga
matɨsipo	ma tɨ sipo
erepotaneso	ere po ta ne so
ikotɨ	i kotɨ
ɨwɨrupi	ɨ wɨ rupi
tu	tu
ipope	i pope
maziʔog	ma zi ʔog
ozemim	o ze mi m
ekojaram	e ko ja ra m
ibaridʒate	i bari dʒ ate
ʔog	ʔ og
opoanba	o po a nba
zomãʔẽnanhar	zo mãʔẽ nan har
derapɨdʒ	de rapɨ dʒ
erenũpã	e re nũpã
otui	o tu i
pegotɨ	pe gotɨ
sipaʔam	si paʔ am
tepedʒapɨakaõwã	te pe d ʒapɨak a õwã
tapiʔirarehe	ta pi ʔi ra rehe
odʒapɨakamãʔẽ	o d ʒapɨak a mãʔẽ
dokuwadʒi	d o kuwa dʒi
aʔenam	aʔe nam
aʔegotɨnẽʔe	aʔe gotɨ nẽ ʔe
iawu	i awu
oʔararehe	o ʔa ra rehe
apotar	a po tar
sə	sə
dokte	d o k te
nãsĩʔõ	nã sĩʔõ
tuʔum	tu ʔu m
zetɨg	ze tɨ g
nõderehe	nõde rehe
oʔar	o ʔar
teresĩ	te re sĩ
zapɨhɨpa	za pɨhɨ pa
nõde	nõd e
imõdo	i mõd o
iwɨb	i wɨ b
kukupope	ku ku pope
adʒu	a dʒu
okurukagarupi	o kuru ka g arupi
aʔereiba	aʔe reiba
datikatu	da t i katu
eibawe	e iba we
kaʔi	ka ʔi
itawa	i ta wa
ipurite	i puri te
iawuŋ	i awu ŋ
aʔepori	aʔe po ri
orekʷar	o re kʷa r
wɨɲanẽ	wɨ ɲa nẽ
zokarakurikom	zo karaku ri kom
pɨanamara	pɨa nam a ra
amãʔẽ	a mãʔẽ
aiɲuŋokar	a iɲuŋ okar
odʒakaʔar	o dʒ a ka ʔar
zarate	zar ate
kija	kij a
kotɨ	kotɨ
watekotɨ	wa t e kotɨ
nipẽrehe	ni pẽ rehe
dizeraʔenawe	d i ze raʔ e na we
ozoka	o zo ka
ikotɨŋ	i kotɨ ŋ
duʔauhu	d uʔa uhu
deradʒɨr	de ra dʒ ɨr
ekuʔi	e ku ʔi
oʔureʔeɲ	o ʔur eʔe ɲ
pekuar	pe kuar
wane	wa n e
wai	wa i
tazepir	ta ze pir
pasiʔɨrehedʒira	pa si ʔɨ rehe dʒi ra
tɨkadɨr	t ɨ ka d ɨr
zapuru	zap u ru
ozikamãʔẽ	o zika mãʔẽ
ibaʔeraɨo	i baʔe ra ɨo
depe	de pe
oibarehe	o iba rehe
dʒasor	dʒ a so r
mais	ma i s
ehekom	ehe kom
tazaugpanane	ta zaug pa nane
ononan	o no nan
nanimãʔẽra	nan i mãʔẽ ra
dobaʔepakatudʒi	d o baʔe pa katu dʒi
aotar	a o tar
ozeɨruʔog	o ze ɨru ʔog
ozewa	o ze wa
sidʒapɨakaõwã	si d ʒapɨak a õwã
apamaʔewi	apam aʔe wi
wanekuwa	wa n e kuwa
zotunaʔɨɲate	zo tu na ʔɨ ɲ ate
nõderapɨdʒam	nõde rapɨ dʒ am
amõ	a mõ
tapug	ta pu g
oanõ	o anõ
eiba	e iba
disimãʔẽɲi	d i si mãʔẽ ɲi
idʒeenam	i dʒ e enam
sidʒewɨranam	si dʒ e wɨr a nam
onaʔaŋtar	o na ʔa ŋ tar
tekoam	teko am
waɨ	wa ɨ
tamãʔẽpope	ta mãʔẽ pope
okaʔarokar	o ka ʔar okar
demõdate	de mõd ate
puri	puri
zaikonam	za iko nam
erapɨdʒape	e rapɨ dʒ ape
aporoekar	a poro ekar
oapɨgeʔeo	o apɨg eʔe o
nõderapɨdʒapope	nõde ra pɨ dʒa pope
ozaʔogoŋ	o za ʔog oŋ
aʔekomaraikʷararupawərareheʔe	aʔe ko ma ra i kʷa ra r upawəra rehe ʔe
baʔe	baʔe
oapɨgo	o apɨg o
nõdutari	nõd u tari
bodʒuhukomãhã	bo dʒ uhu kom ãhã
baʔekom	baʔe kom
ererekʷar	ere re kʷa r
peotar	pe o tar
nõdeapisitanẽ	nõde a pi si ta nẽ
apamaʔesiparate	apam aʔe si par ate
airuɲmãʔẽ	a iru ɲ mãʔẽ
dzewaka	d ze wa ka
sĩ	sĩ
sikədʒi	si kə dʒi
nõderaɨhɨpadʒira	nõde ra ɨhɨ pa dʒi ra
edʒɨawe	e dʒ ɨ a we
azewirtar	a ze wir tar
eakã	eakã
ba	ba
